%%%%%%%%%%%%
%        2 %
%      %%%%%
%%%%%      %
%1      o  %
%%%%%%%%%%%%
